{
  "name": "World 1-1",
  "width_tiles": 250,
  "height_tiles": 19,
  "background_color": [92, 148, 252],
  "spawn": {
    "x": 2,
    "y": 13
  },
  "goal": {
    "x": 245,
    "y": 13
  },
  "legend": {
    ".": "empty",
    "G": "ground",
    "B": "brick",
    "Q": "question_block",
    "P": "pipe",
    "C": "coin",
    "F": "flag",
    "S": "stair_block"
  },
  "tiles": [
    "..........................................................................................................................................................................................................................................................",
    "..........................................................................................................................................................................................................................................................",
    "..................................................................................CCC....C...C...................................................................................................................CCC......CC...................CCC........",
    "..........................................................................................................................................................................................................................................................",
    ".................................................................................................................................CC.......................................................................................................................",
    "................................................................C.........................................................................................................................................................................................",
    "..........................................................................................................................................................................................................................................................",
    "......................Q.........................................................BBBBBBBB...BBBQ..............Q...........BBB....BQQB.......................................................SS.................BBBQBBBB...BBBB...................B.........",
    "...................................................................................CC.........C...........................................................................................SSS...................CCC............CCC........................",
    ".........................................................................................................................................................................................SSSS................................BBQBBBB.....................F",
    "................................................................B.......................................................................................................BBQB............SSSSS............................................................P",
    "................Q...BQBQB.....................PP.........PP..................BQB..............B.....BB....Q..Q..Q.....B..........BB......S..S..........SS..S...........................SSSSSS............BBQBBQBB...............................B........P",
    "......................................PP......PP.........PP.............................................................................SS..SS........SSS..SS......PP.................SSSSSSS........................S...S......BQBB.....................P",
    "............................PP........PP......PP.........PP............................................................................SSS..SSS......SSSS..SSS.....PP.............PP.SSSSSSSS.......................SS...SS..............................P",
    "............................PP........PP......PP.........PP...........................................................................SSSS..SSSS....SSSSS..SSSS....PP.............PPSSSSSSSSS......................SSS...SSSS............................P",
    "GGGGGGGGGGGGGGGGGGGGGGGGGGGGGGGGGGGGGGGGGGGGGGGGGGGGGGGGGGGGGGGGGGGGG..GGGGGGGGGGGGGGG...GGGGGGGGGGGGGGGGGGGGGGGGGGGGGGGGGGGGGGGGGGGGGGGGGGGGGGGGGGGGGGGG..GGGGGGGGGGGGGGGGGGGGGGGGGGGGGGGGGGG.....GGGGGGGGGGGGGGGGGGG...GGGGGGGGGGGGGGGGGGGGGGGGGGGGGGGGG",
    "GGGGGGGGGGGGGGGGGGGGGGGGGGGGGGGGGGGGGGGGGGGGGGGGGGGGGGGGGGGGGGGGGGGGG..GGGGGGGGGGGGGGG...GGGGGGGGGGGGGGGGGGGGGGGGGGGGGGGGGGGGGGGGGGGGGGGGGGGGGGGGGGGGGGGG..GGGGGGGGGGGGGGGGGGGGGGGGGGGGGGGGGGG.....GGGGGGGGGGGGGGGGGGG...GGGGGGGGGGGGGGGGGGGGGGGGGGGGGGGGG",
    "GGGGGGGGGGGGGGGGGGGGGGGGGGGGGGGGGGGGGGGGGGGGGGGGGGGGGGGGGGGGGGGGGGGGG..GGGGGGGGGGGGGGG...GGGGGGGGGGGGGGGGGGGGGGGGGGGGGGGGGGGGGGGGGGGGGGGGGGGGGGGGGGGGGGGG..GGGGGGGGGGGGGGGGGGGGGGGGGGGGGGGGGGG.....GGGGGGGGGGGGGGGGGGG...GGGGGGGGGGGGGGGGGGGGGGGGGGGGGGGGG",
    "GGGGGGGGGGGGGGGGGGGGGGGGGGGGGGGGGGGGGGGGGGGGGGGGGGGGGGGGGGGGGGGGGGGGG..GGGGGGGGGGGGGGG...GGGGGGGGGGGGGGGGGGGGGGGGGGGGGGGGGGGGGGGGGGGGGGGGGGGGGGGGGGGGGGGG..GGGGGGGGGGGGGGGGGGGGGGGGGGGGGGGGGGG.....GGGGGGGGGGGGGGGGGGG...GGGGGGGGGGGGGGGGGGGGGGGGGGGGGGGGG"
  ]
}
